#######
# $.  #
# *   #
# *   #
# *** #
#   * #
##  * #
 ## * #
  # * #
  ## @#
   ####