#########
#   #...#
# $ @.*.#
#  $#*..#
# $ # * #
#  $#$  #
# $ # $ #
#       #
#########