  ####
### @#
#    #
# .#.###
# $    #
##*#*# #
# $    #
#   ####
#####