############
#      #   #
# # $      #
# ##$####$##
#     @#   #
###### $   #
    ## #####
    #  ....#
    #  #####
    #  #
    ####