#########
#   #...#
# $ @.*.#
#  $#*..#
# $ # $ #
#  $#$  #
# $ #   #
#   #   #
#########